kiwulo	drive
fabutu	drink
babot	square
kajona	right
sujosi	left
nuwoma	stand
bolapo	look
tijumi	toe
nanipi	throat
tawole	muscle
kululu	nose
jusuti	knees
babej	head
fafaku	heart
jiwos	hand
nipepo	ear
sotuja	shoulders
lifelu	eye
kifeji	fly
poteto	circle