koleti	green
koloke	guitar
paketa	thinking
temuwi	picture
wamilu	kiss
puwitu	sit
kubitu	red
nonisa	triangle
mesuba	wave
watemu	clap
pojeja	cheeks
wepipo	swim
wosufo	climb
nojime	big
kepetu	small
jonefu	low
kepete	chicken
jabube	monkey
fokibu	hide
jineme	dance